%%%%%%%%%%%%%%%%%%%%%
%   %.              %
% % %%% %%%%% % % % %
% % % % % %         %
%%% %%%%% % %%% % %%%
% % % % %           %
% %%% % %%%%% %%% % % 
% % % % % % %       %
%%%%%%% % % % % % % %
% % % % % %         %
% %%% % % % %%%%%%% %
% % % % % %         %
% % %%% % %%%%%%% % %
% % % % % % %       %
% %%% %%%%% % % %%% %
% % % %             %
% %%%%%%%%%%% %%%%% %
% % % %             %
% % % % %%% % %%%%% %
% % % %            P%
%%%%%%%%%%%%%%%%%%%%%